111111111
11P000E01
100C00001
111111111