1111111111111111111111111111111111
1E0000000000000C00000C000000000001
101001010010000010100100000P010101
1110010010101010001001000000010101
1111111111111111111111111111111111