1111111111111111111111111111111111
1000000000000000000000000000000E11
100C000000000000000000000000000001
100C00000000000P000000000000000001
100C000000000000000000000000000001
100C000000000000000000000000000001
100C000000000000000000000000000001
100C000000000000000000000000000001
100C000000000000000000000000000001
100C000000000000000000000000000001
100C000000000000000000000000000011
100C000000000000000000000000000001
100C00000000000000000B000000000001
100C000000000000000000000000000001
1111111111111111111111111111111111