1111111111111
10010000000C1
10000011100B1
1P001100000E1
1111111111111