111111111
11P000E01
100C00B01
111111111