11111111
100000E1
100CP001
11111111