11111111111111
11P000E0000001
100C00B0000001
10000000000001
10000000000001
10000000000001
10000000000001
11111111111111