11111111
100B00E1
100CP001
11111111