1111111111111
10010000000C1
1B00001110001
1P001100000E1
1111111111111